crescente,date,day,decrescente,point,survey,total
1413,01/07,1,1160,146,7,2573
1044,02/07,2,1421,146,7,2465
1224,03/07,3,1218,146,7,2442
1269,04/07,4,981,146,7,2250
1168,05/07,5,997,146,7,2165
1309,06/07,6,1048,146,7,2357
1889,07/07,7,1230,146,7,3119
3798,01/07,1,3277,123,7,7075
2948,02/07,2,3619,123,7,6567
4134,03/07,3,4563,123,7,8697
4140,04/07,4,4505,123,7,8645
4378,05/07,5,4255,123,7,8633
4210,06/07,6,3951,123,7,8161
4696,07/07,7,4463,123,7,9159
1675,01/07,1,1318,55,7,2993
1172,02/07,2,1587,55,7,2759
1089,03/07,3,956,55,7,2045
1198,04/07,4,1260,55,7,2458
1142,05/07,5,1327,55,7,2469
1232,06/07,6,1343,55,7,2575
1218,07/07,7,1326,55,7,2544
17448,01/07,1,19544,298,7,36992
23211,02/07,2,10319,298,7,33530
20317,03/07,3,12507,298,7,32824
19771,04/07,4,13823,298,7,33594
14738,05/07,5,16414,298,7,31152
18627,06/07,6,14307,298,7,32934
19748,07/07,7,14994,298,7,34742
961,01/07,1,1041,12,7,2002
1005,02/07,2,733,12,7,1738
941,03/07,3,932,12,7,1873
941,04/07,4,965,12,7,1906
1225,05/07,5,1003,12,7,2228
1080,06/07,6,1036,12,7,2116
1108,07/07,7,1067,12,7,2175
4196,01/07,1,5370,111,7,9566
4194,02/07,2,3541,111,7,7735
4275,03/07,3,5567,111,7,9842
4167,04/07,4,5323,111,7,9490
4021,05/07,5,5364,111,7,9385
4400,06/07,6,5557,111,7,9957
4524,07/07,7,6532,111,7,11056
10670,01/07,1,13644,31,7,24314
13721,02/07,2,9607,31,7,23328
11457,03/07,3,10988,31,7,22445
10852,04/07,4,10349,31,7,21201
10953,05/07,5,11264,31,7,22217
11266,06/07,6,11199,31,7,22465
12850,07/07,7,14045,31,7,26895
2227,01/07,1,2564,126,7,4791
1946,02/07,2,2724,126,7,4670
2259,03/07,3,2235,126,7,4494
2470,04/07,4,2182,126,7,4652
2309,05/07,5,2156,126,7,4465
2218,06/07,6,2224,126,7,4442
2217,07/07,7,2237,126,7,4454
2318,01/07,1,2303,143,7,4621
2062,02/07,2,2018,143,7,4080
2775,03/07,3,3384,143,7,6159
3016,04/07,4,2968,143,7,5984
2958,05/07,5,3130,143,7,6088
3032,06/07,6,3182,143,7,6214
3631,07/07,7,3913,143,7,7544
3282,01/07,1,4055,7,7,7337
2776,02/07,2,3032,7,7,5808
4364,03/07,3,3931,7,7,8295
4000,04/07,4,3897,7,7,7897
4126,05/07,5,4130,7,7,8256
4152,06/07,6,3827,7,7,7979
4206,07/07,7,3643,7,7,7849
5460,01/07,1,6213,16,7,11673
5398,02/07,2,3993,16,7,9391
6645,03/07,3,6927,16,7,13572
5576,04/07,4,5795,16,7,11371
6060,05/07,5,6251,16,7,12311
6215,06/07,6,5808,16,7,12023
7774,07/07,7,6234,16,7,14008
3945,01/07,1,3572,58,7,7517
3405,02/07,2,3638,58,7,7043
4165,03/07,3,4168,58,7,8333
3882,04/07,4,4689,58,7,8571
4655,05/07,5,4407,58,7,9062
4574,06/07,6,4752,58,7,9326
4615,07/07,7,4741,58,7,9356
7765,01/07,1,7259,56,7,15024
7296,02/07,2,5638,56,7,12934
9253,03/07,3,8173,56,7,17426
8198,04/07,4,7291,56,7,15489
8449,05/07,5,6060,56,7,14509
8628,06/07,6,7362,56,7,15990
9723,07/07,7,7770,56,7,17493
8870,01/07,1,7586,74,7,16456
8533,02/07,2,6866,74,7,15399
9157,03/07,3,7728,74,7,16885
8929,04/07,4,7052,74,7,15981
8139,05/07,5,7491,74,7,15630
7483,06/07,6,7524,74,7,15007
8969,07/07,7,8954,74,7,17923
11079,01/07,1,13958,220,7,25037
9779,02/07,2,9911,220,7,19690
13313,03/07,3,12333,220,7,25646
12124,04/07,4,14052,220,7,26176
12931,05/07,5,13844,220,7,26775
12809,06/07,6,12132,220,7,24941
12692,07/07,7,14372,220,7,27064
4435,01/07,1,2959,244,7,7394
2913,02/07,2,2697,244,7,5610
5034,03/07,3,2908,244,7,7942
5004,04/07,4,3093,244,7,8097
4647,05/07,5,2937,244,7,7584
4890,06/07,6,3227,244,7,8117
5574,07/07,7,3819,244,7,9393
8731,01/07,1,8027,78,7,16758
7269,02/07,2,8826,78,7,16095
9997,03/07,3,11020,78,7,21017
9877,04/07,4,10212,78,7,20089
9827,05/07,5,9584,78,7,19411
9713,06/07,6,10268,78,7,19981
11853,07/07,7,11752,78,7,23605
8707,01/07,1,6942,101,7,15649
6163,02/07,2,8022,101,7,14185
8491,03/07,3,10027,101,7,18518
8616,04/07,4,8942,101,7,17558
8906,05/07,5,9109,101,7,18015
8916,06/07,6,8761,101,7,17677
10285,07/07,7,9641,101,7,19926
2118,01/07,1,1878,255,7,3996
1821,02/07,2,1569,255,7,3390
2639,03/07,3,2464,255,7,5103
2258,04/07,4,2287,255,7,4545
2664,05/07,5,1978,255,7,4642
2398,06/07,6,2270,255,7,4668
2518,07/07,7,2186,255,7,4704
3614,01/07,1,3402,252,7,7016
4103,02/07,2,2319,252,7,6422
4433,03/07,3,2667,252,7,7100
4155,04/07,4,2565,252,7,6720
4143,05/07,5,2514,252,7,6657
4024,06/07,6,2621,252,7,6645
4348,07/07,7,3489,252,7,7837
7689,01/07,1,5670,13,7,13359
4747,02/07,2,6888,13,7,11635
6946,03/07,3,7496,13,7,14442
6361,04/07,4,5693,13,7,12054
6680,05/07,5,5997,13,7,12677
6609,06/07,6,7091,13,7,13700
9020,07/07,7,7897,13,7,16917
3017,01/07,1,2868,140,7,5885
2149,02/07,2,2775,140,7,4924
2660,03/07,3,3061,140,7,5721
2830,04/07,4,2907,140,7,5737
2751,05/07,5,3087,140,7,5838
3208,06/07,6,2844,140,7,6052
3203,07/07,7,3296,140,7,6499
4472,01/07,1,3746,9,7,8218
3524,02/07,2,5324,9,7,8848
3437,03/07,3,4732,9,7,8169
3536,04/07,4,3562,9,7,7098
4184,05/07,5,3700,9,7,7884
3808,06/07,6,3668,9,7,7476
4528,07/07,7,4130,9,7,8658
2426,01/07,1,2550,177,7,4976
2028,02/07,2,2247,177,7,4275
2359,03/07,3,2270,177,7,4629
2077,04/07,4,2099,177,7,4176
2276,05/07,5,2214,177,7,4490
2477,06/07,6,2344,177,7,4821
2578,07/07,7,2702,177,7,5280
4263,01/07,1,4709,37,7,8972
4672,02/07,2,3549,37,7,8221
4822,03/07,3,4230,37,7,9052
4429,04/07,4,4146,37,7,8575
4293,05/07,5,4296,37,7,8589
4416,06/07,6,3978,37,7,8394
4646,07/07,7,5177,37,7,9823
2017,01/07,1,1722,59,7,3739
1753,02/07,2,2049,59,7,3802
1714,03/07,3,2034,59,7,3748
2034,04/07,4,2017,59,7,4051
2041,05/07,5,1906,59,7,3947
2123,06/07,6,1793,59,7,3916
2395,07/07,7,1874,59,7,4269
13325,01/07,1,18278,117,7,31603
17124,02/07,2,11912,117,7,29036
16244,03/07,3,19423,117,7,35667
14612,04/07,4,18287,117,7,32899
14268,05/07,5,20895,117,7,35163
14726,06/07,6,24070,117,7,38796
19332,07/07,7,20903,117,7,40235
9338,01/07,1,7057,104,7,16395
6587,02/07,2,9938,104,7,16525
7076,03/07,3,8737,104,7,15813
8358,04/07,4,8377,104,7,16735
8453,05/07,5,8638,104,7,17091
10229,06/07,6,9276,104,7,19505
10654,07/07,7,8578,104,7,19232
7698,01/07,1,6779,83,7,14477
6021,02/07,2,8002,83,7,14023
7143,03/07,3,6834,83,7,13977
6689,04/07,4,6560,83,7,13249
6766,05/07,5,6693,83,7,13459
7430,06/07,6,7064,83,7,14494
8141,07/07,7,8371,83,7,16512
21239,01/07,1,23513,103,7,44752
17003,02/07,2,24220,103,7,41223
21805,03/07,3,25545,103,7,47350
22000,04/07,4,26195,103,7,48195
23744,05/07,5,24658,103,7,48402
23214,06/07,6,24979,103,7,48193
21719,07/07,7,25745,103,7,47464
20002,01/07,1,22251,279,7,42253
26070,02/07,2,21908,279,7,47978
19494,03/07,3,19561,279,7,39055
20264,04/07,4,19466,279,7,39730
18917,05/07,5,19009,279,7,37926
19932,06/07,6,19249,279,7,39181
22075,07/07,7,23246,279,7,45321
589,01/07,1,790,198,7,1379
751,02/07,2,531,198,7,1282
726,03/07,3,794,198,7,1520
697,04/07,4,796,198,7,1493
746,05/07,5,795,198,7,1541
752,06/07,6,791,198,7,1543
823,07/07,7,941,198,7,1764
13108,01/07,1,9552,281,7,22660
7569,02/07,2,11181,281,7,18750
9365,03/07,3,10721,281,7,20086
11113,04/07,4,9584,281,7,20697
11565,05/07,5,10726,281,7,22291
11853,06/07,6,11833,281,7,23686
10989,07/07,7,9849,281,7,20838
15462,01/07,1,18107,280,7,33569
21689,02/07,2,15588,280,7,37277
17423,03/07,3,17441,280,7,34864
16185,04/07,4,16619,280,7,32804
17342,05/07,5,16881,280,7,34223
17365,06/07,6,16634,280,7,33999
16720,07/07,7,18099,280,7,34819
2471,01/07,1,2618,62,7,5089
2409,02/07,2,1950,62,7,4359
2988,03/07,3,2699,62,7,5687
2894,04/07,4,2771,62,7,5665
3064,05/07,5,2737,62,7,5801
3098,06/07,6,2878,62,7,5976
3420,07/07,7,3305,62,7,6725
2723,01/07,1,3058,10,7,5781
2172,02/07,2,2352,10,7,4524
2627,03/07,3,2382,10,7,5009
2766,04/07,4,2536,10,7,5302
2664,05/07,5,2584,10,7,5248
2696,06/07,6,2633,10,7,5329
2551,07/07,7,2283,10,7,4834
877,01/07,1,737,223,7,1614
558,02/07,2,674,223,7,1232
920,03/07,3,759,223,7,1679
889,04/07,4,728,223,7,1617
761,05/07,5,771,223,7,1532
836,06/07,6,783,223,7,1619
925,07/07,7,913,223,7,1838
4089,01/07,1,4260,161,7,8349
3582,02/07,2,4056,161,7,7638
3363,03/07,3,3209,161,7,6572
3268,04/07,4,3510,161,7,6778
3227,05/07,5,2972,161,7,6199
3521,06/07,6,3396,161,7,6917
3868,07/07,7,3836,161,7,7704
3330,01/07,1,3077,26,7,6407
2509,02/07,2,2798,26,7,5307
3006,03/07,3,3515,26,7,6521
3347,04/07,4,3122,26,7,6469
3304,05/07,5,3501,26,7,6805
3802,06/07,6,3553,26,7,7355
3722,07/07,7,3403,26,7,7125
4547,01/07,1,5795,38,7,10342
5303,02/07,2,4854,38,7,10157
4736,03/07,3,3957,38,7,8693
4238,04/07,4,4381,38,7,8619
4284,05/07,5,4206,38,7,8490
4432,06/07,6,4684,38,7,9116
4837,07/07,7,5961,38,7,10798
2837,01/07,1,2437,22,7,5274
2833,02/07,2,2187,22,7,5020
2461,03/07,3,1903,22,7,4364
2177,04/07,4,1712,22,7,3889
2087,05/07,5,2073,22,7,4160
2561,06/07,6,2206,22,7,4767
2744,07/07,7,2084,22,7,4828
468,01/07,1,717,110,7,1185
435,02/07,2,808,110,7,1243
461,03/07,3,679,110,7,1140
548,04/07,4,684,110,7,1232
528,05/07,5,734,110,7,1262
583,06/07,6,767,110,7,1350
598,07/07,7,1023,110,7,1621
2832,01/07,1,1992,288,7,4824
1758,02/07,2,2060,288,7,3818
2420,03/07,3,2772,288,7,5192
2449,04/07,4,2530,288,7,4979
2487,05/07,5,2309,288,7,4796
2530,06/07,6,2676,288,7,5206
3178,07/07,7,2849,288,7,6027
1165,01/07,1,1284,205,7,2449
1255,02/07,2,1060,205,7,2315
1162,03/07,3,1154,205,7,2316
1017,04/07,4,1046,205,7,2063
1102,05/07,5,1129,205,7,2231
1121,06/07,6,1135,205,7,2256
1255,07/07,7,1448,205,7,2703
754,01/07,1,677,268,7,1431
694,02/07,2,794,268,7,1488
818,03/07,3,957,268,7,1775
851,04/07,4,910,268,7,1761
881,05/07,5,873,268,7,1754
917,06/07,6,835,268,7,1752
1157,07/07,7,924,268,7,2081
2996,01/07,1,2943,97,7,5939
2903,02/07,2,2593,97,7,5496
3295,03/07,3,3364,97,7,6659
3344,04/07,4,3362,97,7,6706
3600,05/07,5,3706,97,7,7306
3639,06/07,6,3253,97,7,6892
3916,07/07,7,3589,97,7,7505
2045,01/07,1,2008,105,7,4053
1766,02/07,2,2123,105,7,3889
1836,03/07,3,2002,105,7,3838
2062,04/07,4,2080,105,7,4142
2034,05/07,5,2040,105,7,4074
2399,06/07,6,2448,105,7,4847
2784,07/07,7,2354,105,7,5138
2246,01/07,1,2246,283,7,4492
1973,02/07,2,2265,283,7,4238
2068,03/07,3,2287,283,7,4355
2078,04/07,4,2260,283,7,4338
2193,05/07,5,2352,283,7,4545
2434,06/07,6,2526,283,7,4960
2707,07/07,7,2576,283,7,5283
2111,01/07,1,2229,108,7,4340
1648,02/07,2,2506,108,7,4154
1441,03/07,3,2132,108,7,3573
1654,04/07,4,2163,108,7,3817
1940,05/07,5,2125,108,7,4065
2078,06/07,6,2175,108,7,4253
2143,07/07,7,2421,108,7,4564
3615,01/07,1,3533,291,7,7148
2595,02/07,2,4036,291,7,6631
3119,03/07,3,3820,291,7,6939
3169,04/07,4,3838,291,7,7007
3272,05/07,5,3799,291,7,7071
3437,06/07,6,4137,291,7,7574
3885,07/07,7,4354,291,7,8239
2291,01/07,1,2745,109,7,5036
1903,02/07,2,2899,109,7,4802
1656,03/07,3,2396,109,7,4052
1787,04/07,4,2465,109,7,4252
2043,05/07,5,2460,109,7,4503
2048,06/07,6,2650,109,7,4698
2179,07/07,7,2967,109,7,5146
3181,01/07,1,3016,169,7,6197
2333,02/07,2,3429,169,7,5762
2365,03/07,3,3169,169,7,5534
2651,04/07,4,2947,169,7,5598
2761,05/07,5,2889,169,7,5650
2940,06/07,6,3038,169,7,5978
3375,07/07,7,3360,169,7,6735
4182,01/07,1,3969,276,7,8151
3523,02/07,2,4086,276,7,7609
5020,03/07,3,5173,276,7,10193
5118,04/07,4,5205,276,7,10323
5139,05/07,5,5285,276,7,10424
5552,06/07,6,5387,276,7,10939
5810,07/07,7,5844,276,7,11654
1348,01/07,1,1614,297,7,2962
1690,02/07,2,1335,297,7,3025
1567,03/07,3,1271,297,7,2838
1459,04/07,4,1475,297,7,2934
1631,05/07,5,1555,297,7,3186
1542,06/07,6,1788,297,7,3330
1487,07/07,7,1719,297,7,3206
4511,01/07,1,5273,33,7,9784
5735,02/07,2,4522,33,7,10257
5928,03/07,3,5270,33,7,11198
5238,04/07,4,5174,33,7,10412
5517,05/07,5,5221,33,7,10738
5745,06/07,6,5919,33,7,11664
5892,07/07,7,6834,33,7,12726
2444,01/07,1,1962,206,7,4406
1503,02/07,2,1688,206,7,3191
2057,03/07,3,2487,206,7,4544
2509,04/07,4,2481,206,7,4990
2237,05/07,5,2322,206,7,4559
2474,06/07,6,2348,206,7,4822
2993,07/07,7,2572,206,7,5565
1493,01/07,1,1579,122,7,3072
1202,02/07,2,1521,122,7,2723
1454,03/07,3,1755,122,7,3209
1440,04/07,4,1285,122,7,2725
1494,05/07,5,1284,122,7,2778
1392,06/07,6,1148,122,7,2540
1433,07/07,7,1228,122,7,2661
1317,01/07,1,1226,293,7,2543
937,02/07,2,1124,293,7,2061
849,03/07,3,1210,293,7,2059
1104,04/07,4,1326,293,7,2430
1125,05/07,5,1380,293,7,2505
1247,06/07,6,1190,293,7,2437
1393,07/07,7,1177,293,7,2570
3392,01/07,1,3878,54,7,7270
3144,02/07,2,3162,54,7,6306
3980,03/07,3,2994,54,7,6974
3487,04/07,4,3703,54,7,7190
3736,05/07,5,3969,54,7,7705
3871,06/07,6,4066,54,7,7937
3570,07/07,7,4101,54,7,7671
898,01/07,1,1121,160,7,2019
820,02/07,2,691,160,7,1511
964,03/07,3,851,160,7,1815
935,04/07,4,907,160,7,1842
921,05/07,5,930,160,7,1851
968,06/07,6,993,160,7,1961
1048,07/07,7,1036,160,7,2084
2887,01/07,1,3217,27,7,6104
2459,02/07,2,2185,27,7,4644
3441,03/07,3,3969,27,7,7410
3440,04/07,4,3794,27,7,7234
3801,05/07,5,4002,27,7,7803
3515,06/07,6,3941,27,7,7456
3999,07/07,7,4281,27,7,8280
336,01/07,1,354,134,7,690
384,02/07,2,329,134,7,713
449,03/07,3,452,134,7,901
441,04/07,4,396,134,7,837
428,05/07,5,450,134,7,878
409,06/07,6,425,134,7,834
420,07/07,7,447,134,7,867
863,01/07,1,1034,290,7,1897
708,02/07,2,699,290,7,1407
1042,03/07,3,841,290,7,1883
1077,04/07,4,982,290,7,2059
1103,05/07,5,975,290,7,2078
1064,06/07,6,1063,290,7,2127
1052,07/07,7,1011,290,7,2063
2111,01/07,1,2169,158,7,4280
1525,02/07,2,1716,158,7,3241
2346,03/07,3,2187,158,7,4533
2554,04/07,4,2036,158,7,4590
2452,05/07,5,2291,158,7,4743
2342,06/07,6,2172,158,7,4514
2417,07/07,7,2110,158,7,4527
3250,01/07,1,2307,79,7,5557
2636,02/07,2,3540,79,7,6176
2935,03/07,3,3433,79,7,6368
2947,04/07,4,2811,79,7,5758
2879,05/07,5,2676,79,7,5555
2832,06/07,6,2791,79,7,5623
3763,07/07,7,3157,79,7,6920
2751,01/07,1,2551,217,7,5302
2484,02/07,2,3312,217,7,5796
3584,03/07,3,3845,217,7,7429
3255,04/07,4,3252,217,7,6507
2699,05/07,5,3052,217,7,5751
3131,06/07,6,3097,217,7,6228
3309,07/07,7,3218,217,7,6527
9648,01/07,1,9930,60,7,19578
8208,02/07,2,8472,60,7,16680
10171,03/07,3,9875,60,7,20046
10700,04/07,4,10057,60,7,20757
9858,05/07,5,11697,60,7,21555
10856,06/07,6,10579,60,7,21435
12634,07/07,7,12035,60,7,24669
5146,01/07,1,7100,102,7,12246
3289,02/07,2,5765,102,7,9054
5242,03/07,3,8157,102,7,13399
5192,04/07,4,7612,102,7,12804
4958,05/07,5,8189,102,7,13147
5186,06/07,6,7946,102,7,13132
5614,07/07,7,9254,102,7,14868
1721,01/07,1,1870,224,7,3591
1927,02/07,2,2047,224,7,3974
2225,03/07,3,2305,224,7,4530
2713,04/07,4,1787,224,7,4500
2987,05/07,5,1756,224,7,4743
2478,06/07,6,1888,224,7,4366
3101,07/07,7,2095,224,7,5196
880,01/07,1,1382,148,7,2262
1607,02/07,2,754,148,7,2361
1053,03/07,3,875,148,7,1928
831,04/07,4,869,148,7,1700
802,05/07,5,777,148,7,1579
860,06/07,6,990,148,7,1850
959,07/07,7,1427,148,7,2386
6902,01/07,1,5325,201,7,12227
5135,02/07,2,8023,201,7,13158
6452,03/07,3,6041,201,7,12493
5627,04/07,4,5408,201,7,11035
6120,05/07,5,5972,201,7,12092
6303,06/07,6,6137,201,7,12440
6853,07/07,7,7308,201,7,14161
6064,01/07,1,5089,17,7,11153
3621,02/07,2,6651,17,7,10272
3716,03/07,3,4311,17,7,8027
3751,04/07,4,3550,17,7,7301
3563,05/07,5,3943,17,7,7506
4225,06/07,6,3617,17,7,7842
4907,07/07,7,4269,17,7,9176
1520,01/07,1,1899,41,7,3419
1914,02/07,2,1465,41,7,3379
1892,03/07,3,1934,41,7,3826
1813,04/07,4,1581,41,7,3394
1852,05/07,5,2020,41,7,3872
1932,06/07,6,2116,41,7,4048
2144,07/07,7,2379,41,7,4523
2510,01/07,1,3636,192,7,6146
2945,02/07,2,4264,192,7,7209
3641,03/07,3,2903,192,7,6544
3420,04/07,4,3582,192,7,7002
3808,05/07,5,6570,192,7,10378
3558,06/07,6,4136,192,7,7694
3514,07/07,7,3914,192,7,7428
1712,01/07,1,1643,254,7,3355
1591,02/07,2,1479,254,7,3070
1927,03/07,3,1756,254,7,3683
1511,04/07,4,1603,254,7,3114
1664,05/07,5,1626,254,7,3290
1863,06/07,6,1753,254,7,3616
1840,07/07,7,1809,254,7,3649
3869,01/07,1,3736,98,7,7605
4228,02/07,2,4299,98,7,8527
4104,03/07,3,4521,98,7,8625
3822,04/07,4,3924,98,7,7746
3892,05/07,5,4392,98,7,8284
4460,06/07,6,4201,98,7,8661
4990,07/07,7,4869,98,7,9859
2058,01/07,1,1751,167,7,3809
1648,02/07,2,2270,167,7,3918
1859,03/07,3,2060,167,7,3919
1846,04/07,4,1822,167,7,3668
1663,05/07,5,1827,167,7,3490
2000,06/07,6,2020,167,7,4020
2417,07/07,7,2141,167,7,4558
1530,01/07,1,1412,5,7,2942
1558,02/07,2,1308,5,7,2866
2198,03/07,3,1929,5,7,4127
1667,04/07,4,1736,5,7,3403
1778,05/07,5,1772,5,7,3550
1709,06/07,6,1702,5,7,3411
2062,07/07,7,1947,5,7,4009
2089,01/07,1,2198,80,7,4287
2407,02/07,2,1909,80,7,4316
2406,03/07,3,2598,80,7,5004
2261,04/07,4,2287,80,7,4548
2254,05/07,5,2283,80,7,4537
2560,06/07,6,2304,80,7,4864
2896,07/07,7,2575,80,7,5471
5452,01/07,1,3361,216,7,8813
3901,02/07,2,4731,216,7,8632
4101,03/07,3,4844,216,7,8945
3879,04/07,4,3309,216,7,7188
5660,05/07,5,3593,216,7,9253
5901,06/07,6,3268,216,7,9169
8829,07/07,7,5224,216,7,14053
3782,01/07,1,3213,65,7,6995
2816,02/07,2,3832,65,7,6648
3531,03/07,3,4306,65,7,7837
3349,04/07,4,3357,65,7,6706
3439,05/07,5,3156,65,7,6595
3598,06/07,6,3431,65,7,7029
4588,07/07,7,4000,65,7,8588
1783,01/07,1,1659,29,7,3442
1761,02/07,2,2149,29,7,3910
2122,03/07,3,2357,29,7,4479
2187,04/07,4,2391,29,7,4578
2165,05/07,5,1936,29,7,4101
2437,06/07,6,2138,29,7,4575
2334,07/07,7,2079,29,7,4413
2108,01/07,1,2331,64,7,4439
1549,02/07,2,2809,64,7,4358
2078,03/07,3,2644,64,7,4722
2031,04/07,4,2087,64,7,4118
2250,05/07,5,2592,64,7,4842
2532,06/07,6,2664,64,7,5196
3281,07/07,7,2627,64,7,5908
1252,01/07,1,1112,132,7,2364
1196,02/07,2,1014,132,7,2210
1253,03/07,3,1381,132,7,2634
1260,04/07,4,1070,132,7,2330
1280,05/07,5,1410,132,7,2690
1422,06/07,6,1272,132,7,2694
1398,07/07,7,1432,132,7,2830
744,01/07,1,1005,227,7,1749
1288,02/07,2,681,227,7,1969
1077,03/07,3,883,227,7,1960
844,04/07,4,889,227,7,1733
685,05/07,5,994,227,7,1679
830,06/07,6,1196,227,7,2026
1058,07/07,7,1847,227,7,2905
1409,01/07,1,1618,150,7,3027
1229,02/07,2,1348,150,7,2577
1568,03/07,3,1742,150,7,3310
1494,04/07,4,1623,150,7,3117
1497,05/07,5,1807,150,7,3304
1521,06/07,6,1702,150,7,3223
1768,07/07,7,2014,150,7,3782
578,01/07,1,644,194,7,1222
574,02/07,2,467,194,7,1041
670,03/07,3,673,194,7,1343
724,04/07,4,635,194,7,1359
623,05/07,5,573,194,7,1196
756,06/07,6,569,194,7,1325
797,07/07,7,772,194,7,1569
608,01/07,1,1161,243,7,1769
1873,02/07,2,1494,243,7,3367
739,03/07,3,750,243,7,1489
504,04/07,4,492,243,7,996
501,05/07,5,534,243,7,1035
522,06/07,6,669,243,7,1191
526,07/07,7,996,243,7,1522
882,01/07,1,1072,180,7,1954
847,02/07,2,753,180,7,1600
1147,03/07,3,1072,180,7,2219
1073,04/07,4,1059,180,7,2132
976,05/07,5,966,180,7,1942
952,06/07,6,948,180,7,1900
1102,07/07,7,1285,180,7,2387
2668,01/07,1,2797,250,7,5465
2231,02/07,2,2147,250,7,4378
2973,03/07,3,2768,250,7,5741
2579,04/07,4,3066,250,7,5645
2694,05/07,5,2542,250,7,5236
3177,06/07,6,2676,250,7,5853
2999,07/07,7,2954,250,7,5953
2272,01/07,1,2207,43,7,4479
2434,02/07,2,1803,43,7,4237
2969,03/07,3,2765,43,7,5734
2681,04/07,4,2740,43,7,5421
2087,05/07,5,2633,43,7,4720
2187,06/07,6,2735,43,7,4922
2738,07/07,7,2729,43,7,5467
1182,01/07,1,1325,155,7,2507
1419,02/07,2,1234,155,7,2653
1258,03/07,3,1043,155,7,2301
1258,04/07,4,1216,155,7,2474
1263,05/07,5,1215,155,7,2478
1442,06/07,6,1425,155,7,2867
1306,07/07,7,1475,155,7,2781
953,01/07,1,869,1,7,1822
719,02/07,2,609,1,7,1328
931,03/07,3,782,1,7,1713
862,04/07,4,714,1,7,1576
786,05/07,5,965,1,7,1751
735,06/07,6,800,1,7,1535
841,07/07,7,789,1,7,1630
1333,01/07,1,1185,156,7,2518
1429,02/07,2,954,156,7,2383
1371,03/07,3,900,156,7,2271
1570,04/07,4,1129,156,7,2699
1422,05/07,5,1166,156,7,2588
1832,06/07,6,1283,156,7,3115
1370,07/07,7,1017,156,7,2387
717,01/07,1,647,257,7,1364
589,02/07,2,594,257,7,1183
692,03/07,3,645,257,7,1337
713,04/07,4,683,257,7,1396
737,05/07,5,724,257,7,1461
698,06/07,6,777,257,7,1475
755,07/07,7,879,257,7,1634
3347,01/07,1,4124,256,7,7471
4349,02/07,2,3237,256,7,7586
3830,03/07,3,3600,256,7,7430
3581,04/07,4,3596,256,7,7177
3462,05/07,5,3474,256,7,6936
3684,06/07,6,3637,256,7,7321
4303,07/07,7,4336,256,7,8639
3305,01/07,1,3446,82,7,6751
3435,02/07,2,2988,82,7,6423
3987,03/07,3,3421,82,7,7408
3739,04/07,4,3432,82,7,7171
4185,05/07,5,3730,82,7,7915
3661,06/07,6,3737,82,7,7398
3762,07/07,7,4439,82,7,8201
2103,01/07,1,2754,168,7,4857
2752,02/07,2,2297,168,7,5049
2656,03/07,3,2935,168,7,5591
2630,04/07,4,2783,168,7,5413
2730,05/07,5,2861,168,7,5591
2575,06/07,6,2916,168,7,5491
3274,07/07,7,3295,168,7,6569
2162,01/07,1,1985,44,7,4147
1914,02/07,2,2086,44,7,4000
2322,03/07,3,2073,44,7,4395
2142,04/07,4,1912,44,7,4054
2232,05/07,5,2140,44,7,4372
2057,06/07,6,2241,44,7,4298
2279,07/07,7,2416,44,7,4695
1451,01/07,1,1408,208,7,2859
1271,02/07,2,1405,208,7,2676
1583,03/07,3,1567,208,7,3150
1632,04/07,4,1669,208,7,3301
1772,05/07,5,1643,208,7,3415
1998,06/07,6,1685,208,7,3683
2145,07/07,7,1915,208,7,4060
6145,01/07,1,7212,212,7,13357
4650,02/07,2,4474,212,7,9124
6942,03/07,3,7176,212,7,14118
6418,04/07,4,7222,212,7,13640
5708,05/07,5,7884,212,7,13592
6489,06/07,6,7516,212,7,14005
6340,07/07,7,8091,212,7,14431
9552,01/07,1,12270,47,7,21822
10502,02/07,2,9863,47,7,20365
10973,03/07,3,11202,47,7,22175
11687,04/07,4,14262,47,7,25949
11642,05/07,5,11387,47,7,23029
12361,06/07,6,12817,47,7,25178
11746,07/07,7,14273,47,7,26019
30476,01/07,1,39002,287,7,69478
34759,02/07,2,22675,287,7,57434
31429,03/07,3,28349,287,7,59778
28849,04/07,4,27097,287,7,55946
29376,05/07,5,29209,287,7,58585
29605,06/07,6,30658,287,7,60263
29936,07/07,7,38828,287,7,68764
14622,01/07,1,19192,106,7,33814
17823,02/07,2,13081,106,7,30904
15372,03/07,3,13868,106,7,29240
14720,04/07,4,14036,106,7,28756
14544,05/07,5,13942,106,7,28486
14501,06/07,6,14991,106,7,29492
15704,07/07,7,19023,106,7,34727
3191,01/07,1,2361,164,7,5552
1742,02/07,2,2679,164,7,4421
2890,03/07,3,3245,164,7,6135
3044,04/07,4,2680,164,7,5724
2658,05/07,5,2862,164,7,5520
2848,06/07,6,3179,164,7,6027
3983,07/07,7,3133,164,7,7116
2687,01/07,1,2901,77,7,5588
2941,02/07,2,2299,77,7,5240
3007,03/07,3,2382,77,7,5389
3625,04/07,4,2730,77,7,6355
2904,05/07,5,2655,77,7,5559
3543,06/07,6,3062,77,7,6605
3181,07/07,7,2811,77,7,5992
2363,01/07,1,3166,241,7,5529
2746,02/07,2,2559,241,7,5305
2623,03/07,3,2883,241,7,5506
3048,04/07,4,2850,241,7,5898
2909,05/07,5,3439,241,7,6348
3037,06/07,6,3820,241,7,6857
2910,07/07,7,3974,241,7,6884
4413,01/07,1,5126,245,7,9539
4138,02/07,2,3632,245,7,7770
4583,03/07,3,4405,245,7,8988
4648,04/07,4,4663,245,7,9311
4695,05/07,5,4947,245,7,9642
4710,06/07,6,5052,245,7,9762
5443,07/07,7,4961,245,7,10404
1468,01/07,1,1212,81,7,2680
1041,02/07,2,1252,81,7,2293
1499,03/07,3,1684,81,7,3183
1224,04/07,4,1433,81,7,2657
1410,05/07,5,1504,81,7,2914
1467,06/07,6,1426,81,7,2893
1639,07/07,7,1605,81,7,3244
701,01/07,1,1028,173,7,1729
531,02/07,2,1181,173,7,1712
607,03/07,3,1211,173,7,1818
673,04/07,4,1199,173,7,1872
823,05/07,5,1116,173,7,1939
758,06/07,6,1179,173,7,1937
804,07/07,7,1341,173,7,2145
2873,01/07,1,4394,253,7,7267
2684,02/07,2,2848,253,7,5532
4604,03/07,3,4118,253,7,8722
3239,04/07,4,3538,253,7,6777
3467,05/07,5,3749,253,7,7216
3558,06/07,6,4002,253,7,7560
3784,07/07,7,4448,253,7,8232
2319,01/07,1,2546,204,7,4865
2247,02/07,2,2121,204,7,4368
2641,03/07,3,2407,204,7,5048
2503,04/07,4,2464,204,7,4967
2551,05/07,5,2514,204,7,5065
2704,06/07,6,2634,204,7,5338
2912,07/07,7,3044,204,7,5956
1470,01/07,1,1650,233,7,3120
1316,02/07,2,1260,233,7,2576
1852,03/07,3,1807,233,7,3659
1849,04/07,4,1864,233,7,3713
1847,05/07,5,1691,233,7,3538
1778,06/07,6,1955,233,7,3733
1920,07/07,7,2198,233,7,4118
3144,01/07,1,3407,278,7,6551
3078,02/07,2,2633,278,7,5711
2750,03/07,3,2848,278,7,5598
2675,04/07,4,2636,278,7,5311
2819,05/07,5,2861,278,7,5680
3179,06/07,6,3876,278,7,7055
4477,07/07,7,4000,278,7,8477
2432,01/07,1,2557,184,7,4989
2681,02/07,2,1926,184,7,4607
2268,03/07,3,2174,184,7,4442
2029,04/07,4,2205,184,7,4234
2300,05/07,5,2182,184,7,4482
2276,06/07,6,2338,184,7,4614
2513,07/07,7,2658,184,7,5171
416,01/07,1,463,249,7,879
462,02/07,2,369,249,7,831
465,03/07,3,496,249,7,961
474,04/07,4,477,249,7,951
490,05/07,5,482,249,7,972
489,06/07,6,496,249,7,985
512,07/07,7,519,249,7,1031
2052,01/07,1,1796,170,7,3848
1370,02/07,2,2188,170,7,3558
1985,03/07,3,1860,170,7,3845
1920,04/07,4,1917,170,7,3837
1966,05/07,5,1976,170,7,3942
1939,06/07,6,1969,170,7,3908
2238,07/07,7,2345,170,7,4583
