crescente,date,day,decrescente,point,survey,total
510,02/07,1,504,211,5,1014
431,03/07,2,473,211,5,904
582,04/07,3,536,211,5,1118
513,05/07,4,561,211,5,1074
646,06/07,5,615,211,5,1261
581,07/07,6,630,211,5,1211
639,08/07,7,644,211,5,1283
13924,02/07,1,12386,92,5,26310
14294,03/07,2,14670,92,5,28964
12422,04/07,3,14293,92,5,26715
13716,05/07,4,13625,92,5,27341
12980,06/07,5,13986,92,5,26966
13436,07/07,6,14187,92,5,27623
15636,08/07,7,15345,92,5,30981
1357,02/07,1,1547,207,5,2904
1293,03/07,2,1142,207,5,2435
1586,04/07,3,1590,207,5,3176
1482,05/07,4,1567,207,5,3049
1454,06/07,5,1569,207,5,3023
1549,07/07,6,1445,207,5,2994
1764,08/07,7,1736,207,5,3500
11028,02/07,1,10355,94,5,21383
9397,03/07,2,12098,94,5,21495
9093,04/07,3,9278,94,5,18371
9049,05/07,4,9472,94,5,18521
8913,06/07,5,9667,94,5,18580
9042,07/07,6,8504,94,5,17546
11159,08/07,7,10256,94,5,21415
10179,02/07,1,10889,95,5,21068
11385,03/07,2,10301,95,5,21686
10882,04/07,3,10433,95,5,21315
10863,05/07,4,10947,95,5,21810
11016,06/07,5,11401,95,5,22417
11026,07/07,6,11336,95,5,22362
12247,08/07,7,13655,95,5,25902
3173,02/07,1,3555,49,5,6728
2925,03/07,2,3305,49,5,6230
3462,04/07,3,2852,49,5,6314
3418,05/07,4,3176,49,5,6594
3396,06/07,5,3118,49,5,6514
3445,07/07,6,3686,49,5,7131
3783,08/07,7,4132,49,5,7915
7446,02/07,1,9582,263,5,17028
10923,03/07,2,6755,263,5,17678
8375,04/07,3,7235,263,5,15610
7316,05/07,4,7667,263,5,14983
7393,06/07,5,7134,263,5,14527
7825,07/07,6,7678,263,5,15503
8853,08/07,7,10772,263,5,19625
1939,02/07,1,1902,214,5,3841
1814,03/07,2,1628,214,5,3442
1827,04/07,3,1766,214,5,3593
1640,05/07,4,1765,214,5,3405
1731,06/07,5,1740,214,5,3471
1844,07/07,6,1701,214,5,3545
1872,08/07,7,1846,214,5,3718
3348,02/07,1,3116,67,5,6464
2827,03/07,2,3322,67,5,6149
3048,04/07,3,2940,67,5,5988
3300,05/07,4,3227,67,5,6527
3154,06/07,5,3241,67,5,6395
3375,07/07,6,3335,67,5,6710
3704,08/07,7,3356,67,5,7060
8496,02/07,1,6362,66,5,14858
7236,03/07,2,9428,66,5,16664
5668,04/07,3,7002,66,5,12670
7743,05/07,4,7853,66,5,15596
7085,06/07,5,7122,66,5,14207
7890,07/07,6,7329,66,5,15219
7877,08/07,7,6264,66,5,14141
1788,02/07,1,1925,87,5,3713
2044,03/07,2,1574,87,5,3618
1716,04/07,3,1962,87,5,3678
1792,05/07,4,1861,87,5,3653
1694,06/07,5,1629,87,5,3323
2037,07/07,6,1760,87,5,3797
2510,08/07,7,2487,87,5,4997
1638,02/07,1,1932,269,5,3570
1381,03/07,2,1224,269,5,2605
1408,04/07,3,1674,269,5,3082
1421,05/07,4,1533,269,5,2954
1417,06/07,5,1474,269,5,2891
1700,07/07,6,1573,269,5,3273
2096,08/07,7,2162,269,5,4258
2019,02/07,1,2342,273,5,4361
1812,03/07,2,1799,273,5,3611
2455,04/07,3,2536,273,5,4991
2435,05/07,4,2602,273,5,5037
2578,06/07,5,2399,273,5,4977
2817,07/07,6,2425,273,5,5242
2787,08/07,7,2917,273,5,5704
3185,02/07,1,2702,119,5,5887
2469,03/07,2,2760,119,5,5229
2707,04/07,3,3180,119,5,5887
3327,05/07,4,3382,119,5,6709
3453,06/07,5,3404,119,5,6857
3948,07/07,6,3737,119,5,7685
4170,08/07,7,3186,119,5,7356
3333,02/07,1,3255,237,5,6588
3207,03/07,2,2722,237,5,5929
3482,04/07,3,3400,237,5,6882
3584,05/07,4,3577,237,5,7161
3810,06/07,5,3648,237,5,7458
4038,07/07,6,3705,237,5,7743
3994,08/07,7,4073,237,5,8067
2071,02/07,1,2055,115,5,4126
2026,03/07,2,1753,115,5,3779
2052,04/07,3,1529,115,5,3581
2144,05/07,4,1873,115,5,4017
2231,06/07,5,1948,115,5,4179
2058,07/07,6,2062,115,5,4120
2055,08/07,7,2425,115,5,4480
4129,02/07,1,4527,85,5,8656
3922,03/07,2,4459,85,5,8381
4297,04/07,3,3658,85,5,7955
4067,05/07,4,3407,85,5,7474
3468,06/07,5,3633,85,5,7101
3686,07/07,6,3957,85,5,7643
4183,08/07,7,4424,85,5,8607
2312,02/07,1,2519,84,5,4831
2319,03/07,2,2029,84,5,4348
2507,04/07,3,2594,84,5,5101
2850,05/07,4,2915,84,5,5765
2519,06/07,5,2480,84,5,4999
2784,07/07,6,2863,84,5,5647
2813,08/07,7,2732,84,5,5545
2893,02/07,1,3054,275,5,5947
2152,03/07,2,2558,275,5,4710
3273,04/07,3,3059,275,5,6332
3212,05/07,4,3003,275,5,6215
3238,06/07,5,3396,275,5,6634
3417,07/07,6,3437,275,5,6854
3454,08/07,7,3687,275,5,7141
2651,02/07,1,2806,2,5,5457
2369,03/07,2,1967,2,5,4336
2985,04/07,3,2581,2,5,5566
2965,05/07,4,2855,2,5,5820
3011,06/07,5,3187,2,5,6198
3089,07/07,6,3128,2,5,6217
3322,08/07,7,3398,2,5,6720
3496,02/07,1,4074,296,5,7570
3695,03/07,2,3191,296,5,6886
3318,04/07,3,3432,296,5,6750
3366,05/07,4,3212,296,5,6578
3439,06/07,5,3361,296,5,6800
3604,07/07,6,3557,296,5,7161
3708,08/07,7,3924,296,5,7632
6158,02/07,1,7049,48,5,13207
5209,03/07,2,5254,48,5,10463
7128,04/07,3,6987,48,5,14115
7341,05/07,4,7597,48,5,14938
8017,06/07,5,7439,48,5,15456
7727,07/07,6,7197,48,5,14924
8941,08/07,7,7524,48,5,16465
4772,02/07,1,5009,53,5,9781
4677,03/07,2,4125,53,5,8802
4417,04/07,3,3929,53,5,8346
4402,05/07,4,4438,53,5,8840
4530,06/07,5,4636,53,5,9166
4880,07/07,6,4419,53,5,9299
5273,08/07,7,5104,53,5,10377
2322,02/07,1,2264,121,5,4586
1877,03/07,2,1699,121,5,3576
2512,04/07,3,2214,121,5,4726
2467,05/07,4,2186,121,5,4653
2390,06/07,5,2351,121,5,4741
2540,07/07,6,2380,121,5,4920
2486,08/07,7,2060,121,5,4546
1471,02/07,1,1809,52,5,3280
1493,03/07,2,1627,52,5,3120
1509,04/07,3,1770,52,5,3279
1454,05/07,4,1739,52,5,3193
1530,06/07,5,2135,52,5,3665
1566,07/07,6,1961,52,5,3527
1986,08/07,7,1752,52,5,3738
907,02/07,1,999,262,5,1906
1082,03/07,2,736,262,5,1818
981,04/07,3,685,262,5,1666
929,05/07,4,791,262,5,1720
913,06/07,5,773,262,5,1686
846,07/07,6,872,262,5,1718
936,08/07,7,954,262,5,1890
629,02/07,1,697,209,5,1326
638,03/07,2,583,209,5,1221
707,04/07,3,453,209,5,1160
711,05/07,4,589,209,5,1300
631,06/07,5,666,209,5,1297
664,07/07,6,677,209,5,1341
702,08/07,7,881,209,5,1583
8964,02/07,1,9721,112,5,18685
10882,03/07,2,8503,112,5,19385
8711,04/07,3,8842,112,5,17553
8833,05/07,4,8133,112,5,16966
8206,06/07,5,8275,112,5,16481
8170,07/07,6,8344,112,5,16514
9449,08/07,7,9990,112,5,19439
8340,02/07,1,7406,69,5,15746
6208,03/07,2,8322,69,5,14530
7498,04/07,3,7970,69,5,15468
8576,05/07,4,8514,69,5,17090
7681,06/07,5,7959,69,5,15640
9040,07/07,6,8846,69,5,17886
7545,08/07,7,9463,69,5,17008
1459,02/07,1,1396,236,5,2855
1438,03/07,2,1486,236,5,2924
1457,04/07,3,1446,236,5,2903
1374,05/07,4,1338,236,5,2712
1260,06/07,5,1293,236,5,2553
1400,07/07,6,1386,236,5,2786
1410,08/07,7,1534,236,5,2944
12297,02/07,1,10451,113,5,22748
10655,03/07,2,12984,113,5,23639
12028,04/07,3,11552,113,5,23580
12383,05/07,4,11374,113,5,23757
11810,06/07,5,11356,113,5,23166
12834,07/07,6,11597,113,5,24431
15458,08/07,7,13064,113,5,28522
2188,02/07,1,2109,114,5,4297
1961,03/07,2,2168,114,5,4129
2010,04/07,3,2139,114,5,4149
2045,05/07,4,2029,114,5,4074
2040,06/07,5,2471,114,5,4511
2110,07/07,6,2531,114,5,4641
2309,08/07,7,2424,114,5,4733
2195,02/07,1,1963,234,5,4158
1851,03/07,2,2054,234,5,3905
2135,04/07,3,2270,234,5,4405
2339,05/07,4,2398,234,5,4737
2358,06/07,5,2348,234,5,4706
2620,07/07,6,2472,234,5,5092
2999,08/07,7,2710,234,5,5709
4880,02/07,1,5575,68,5,10455
4388,03/07,2,3833,68,5,8221
4998,04/07,3,4611,68,5,9609
5322,05/07,4,4687,68,5,10009
4840,06/07,5,4568,68,5,9408
5079,07/07,6,4586,68,5,9665
5941,08/07,7,5530,68,5,11471
2024,02/07,1,1624,300,5,3648
1694,03/07,2,2128,300,5,3822
2214,04/07,3,2183,300,5,4397
2149,05/07,4,2071,300,5,4220
1987,06/07,5,2020,300,5,4007
2234,07/07,6,2138,300,5,4372
2664,08/07,7,2364,300,5,5028
1566,02/07,1,1278,272,5,2844
1205,03/07,2,1359,272,5,2564
1867,04/07,3,1903,272,5,3770
1697,05/07,4,1695,272,5,3392
1807,06/07,5,1582,272,5,3389
1870,07/07,6,1866,272,5,3736
2147,08/07,7,1793,272,5,3940
2400,02/07,1,1879,274,5,4279
2427,03/07,2,2683,274,5,5110
2241,04/07,3,2032,274,5,4273
2031,05/07,4,1831,274,5,3862
2005,06/07,5,1892,274,5,3897
2067,07/07,6,2080,274,5,4147
3120,08/07,7,2911,274,5,6031
3273,02/07,1,3143,265,5,6416
2763,03/07,2,2819,265,5,5582
4142,04/07,3,3804,265,5,7946
3585,05/07,4,3527,265,5,7112
3401,06/07,5,3098,265,5,6499
3762,07/07,6,3914,265,5,7676
4322,08/07,7,4308,265,5,8630
2954,02/07,1,3140,99,5,6094
2974,03/07,2,2450,99,5,5424
3196,04/07,3,3281,99,5,6477
3201,05/07,4,3274,99,5,6475
3395,06/07,5,3281,99,5,6676
3376,07/07,6,3324,99,5,6700
3561,08/07,7,3362,99,5,6923
7406,02/07,1,7961,118,5,15367
6805,03/07,2,5727,118,5,12532
7632,04/07,3,7885,118,5,15517
7908,05/07,4,8236,118,5,16144
7678,06/07,5,8154,118,5,15832
7792,07/07,6,8244,118,5,16036
8572,08/07,7,8967,118,5,17539
2957,02/07,1,2537,86,5,5494
2485,03/07,2,3271,86,5,5756
2818,04/07,3,2721,86,5,5539
2836,05/07,4,2612,86,5,5448
2648,06/07,5,2404,86,5,5052
3164,07/07,6,2821,86,5,5985
3376,08/07,7,3458,86,5,6834
1136,02/07,1,1099,88,5,2235
887,03/07,2,816,88,5,1703
1149,04/07,3,1168,88,5,2317
930,05/07,4,977,88,5,1907
1064,06/07,5,1140,88,5,2204
1162,07/07,6,1312,88,5,2474
1242,08/07,7,1351,88,5,2593
963,02/07,1,855,89,5,1818
700,03/07,2,745,89,5,1445
994,04/07,3,1079,89,5,2073
1415,05/07,4,1193,89,5,2608
1597,06/07,5,1551,89,5,3148
1092,07/07,6,1451,89,5,2543
1236,08/07,7,1189,89,5,2425
4124,02/07,1,3812,240,5,7936
3519,03/07,2,3296,240,5,6815
4252,04/07,3,4213,240,5,8465
4510,05/07,4,4403,240,5,8913
4436,06/07,5,3932,240,5,8368
4208,07/07,6,3998,240,5,8206
5235,08/07,7,4272,240,5,9507
454,02/07,1,471,210,5,925
417,03/07,2,426,210,5,843
358,04/07,3,446,210,5,804
406,05/07,4,429,210,5,835
414,06/07,5,389,210,5,803
480,07/07,6,498,210,5,978
427,08/07,7,507,210,5,934
1059,02/07,1,1005,235,5,2064
1083,03/07,2,1137,235,5,2220
1188,04/07,3,1233,235,5,2421
1197,05/07,4,1234,235,5,2431
1148,06/07,5,1126,235,5,2274
1155,07/07,6,1184,235,5,2339
1508,08/07,7,1336,235,5,2844
4009,02/07,1,3712,295,5,7721
3317,03/07,2,4058,295,5,7375
4089,04/07,3,4071,295,5,8160
4245,05/07,4,4105,295,5,8350
4300,06/07,5,4229,295,5,8529
4633,07/07,6,4577,295,5,9210
5474,08/07,7,5645,295,5,11119
555,02/07,1,577,267,5,1132
544,03/07,2,462,267,5,1006
543,04/07,3,619,267,5,1162
494,05/07,4,499,267,5,993
487,06/07,5,486,267,5,973
510,07/07,6,536,267,5,1046
687,08/07,7,637,267,5,1324
13522,02/07,1,11987,71,5,25509
13864,03/07,2,16150,71,5,30014
10426,04/07,3,13869,71,5,24295
10695,05/07,4,12128,71,5,22823
10970,06/07,5,10950,71,5,21920
10568,07/07,6,10827,71,5,21395
16438,08/07,7,9422,71,5,25860
9585,02/07,1,11206,264,5,20791
11536,03/07,2,9897,264,5,21433
12472,04/07,3,12414,264,5,24886
11980,05/07,4,12259,264,5,24239
11543,06/07,5,11153,264,5,22696
12397,07/07,6,12782,264,5,25179
13269,08/07,7,15031,264,5,28300
5157,02/07,1,4672,90,5,9829
4472,03/07,2,5146,90,5,9618
5136,04/07,3,6614,90,5,11750
5744,05/07,4,6160,90,5,11904
5675,06/07,5,5641,90,5,11316
5942,07/07,6,5671,90,5,11613
6790,08/07,7,5402,90,5,12192
529,02/07,1,474,266,5,1003
423,03/07,2,435,266,5,858
517,04/07,3,581,266,5,1098
445,05/07,4,460,266,5,905
465,06/07,5,429,266,5,894
425,07/07,6,461,266,5,886
505,08/07,7,403,266,5,908
10247,02/07,1,10716,299,5,20963
8683,03/07,2,9570,299,5,18253
8158,04/07,3,9691,299,5,17849
7903,05/07,4,9565,299,5,17468
7936,06/07,5,9454,299,5,17390
8326,07/07,6,8999,299,5,17325
8621,08/07,7,8903,299,5,17524
2534,02/07,1,1485,271,5,4019
1184,03/07,2,3591,271,5,4775
1185,04/07,3,1569,271,5,2754
1071,05/07,4,1047,271,5,2118
970,06/07,5,1041,271,5,2011
1123,07/07,6,1184,271,5,2307
1975,08/07,7,1406,271,5,3381
739,02/07,1,600,270,5,1339
602,03/07,2,642,270,5,1244
834,04/07,3,628,270,5,1462
659,05/07,4,509,270,5,1168
601,06/07,5,509,270,5,1110
740,07/07,6,658,270,5,1398
813,08/07,7,800,270,5,1613
22043,02/07,1,19224,93,5,41267
17319,03/07,2,15775,93,5,33094
17373,04/07,3,14878,93,5,32251
17891,05/07,4,19926,93,5,37817
18059,06/07,5,18441,93,5,36500
24141,07/07,6,22765,93,5,46906
25917,08/07,7,24914,93,5,50831
530,02/07,1,544,91,5,1074
462,03/07,2,334,91,5,796
769,04/07,3,565,91,5,1334
613,05/07,4,515,91,5,1128
598,06/07,5,591,91,5,1189
673,07/07,6,582,91,5,1255
726,08/07,7,780,91,5,1506
4190,02/07,1,3157,72,5,7347
3004,03/07,2,4679,72,5,7683
3282,04/07,3,3440,72,5,6722
3621,05/07,4,3732,72,5,7353
3591,06/07,5,3724,72,5,7315
3950,07/07,6,3571,72,5,7521
4248,08/07,7,3662,72,5,7910
2102,02/07,1,2385,232,5,4487
2043,03/07,2,1876,232,5,3919
2312,04/07,3,2503,232,5,4815
2342,05/07,4,2459,232,5,4801
2265,06/07,5,2457,232,5,4722
2408,07/07,6,2497,232,5,4905
2790,08/07,7,2749,232,5,5539
